. . . . . . . .
. . . . . . . .
. . . 1 . . . .
. W . . . . 1 .
. . . . . 1 . .
. . 2 . 2 . . .
. . . . . . . .
. . . . . . . .