. . . . . . . . .
. . . . 1 . . . .
. . . . . . . 1 .
. 2 . . . . . 1 .
. . . W . . 1 . .
. . . . . . 1 . .
. . . 1 . . 2 . .
. . 3 . . 3 . . .
. . . . . . . . .
