. . . . . . . .
. . . . 2 . . .
. 3 . . . . . .
. . . . . . . .
. . . W . 1 . .
. . . . . . . .
. . . . . . . .
. . . . . . . .
