. . . . . . . .
. . . . . . . .
. 3 . . . . 2 .
. . . . . . . .
. . 1 W . . . .
. . . . . . . .
. . . . . . . .
. . . . . . . .