. . . . . 3 . .
. 4 . . . . . .
. . . . . . . .
. . . . . . . .
. . . W . . 2 .
. . . . . . . .
. . . . . . . .
. . . . . . . .