. . . . . . . . . .
. . . . . . . . . .
. . W . . . . 4 . .
. . . . . . . . . .
. . . 1 . . . . . .
. . . . . . . . . .
. . . . 3 . . . . .
. . . . . . . . . .
. . 4 . . . . . . .
. . . . . . . . . .
