. 1 . . .
. . . . 3
1 . W . .
. . . . .
. . . . .