. . 2 . .
. 1 . 1 .
. 2 . . .
. 2 . . .
W . . . 1