. 1 . 1 .
3 . . . .
1 . . . W
. . . . .
. . 2 . .
