. . . . . . . . .
. . . . . . . . .
. . 5 . . 4 . . .
. . . . . . . . .
. . . . . . . . .
. . . 2 . . . . .
. . . . . . . . .
. 3 . . . . W . .
. . . . . . . . .
