. 1 . 1 .
3 . . . .
1 . . . W
1 . . . .
. 1 1 . .
