. . . . . . . . . .
. . . . . . . . . .
. . . 2 . 1 . . . .
. . . . . 2 . . . .
. . . . . . . . 3 .
1 . . . W . . . 1 .
. . 1 . . . . 1 . .
. . . . 1 . . . . .
. . . . . . . . . .
. . . . . . . . . .
